B                                     
                                      
                                      
                                      
                                      
         11111111111111111111         
                 11                   
            1    1                    
     11111111    1                    
o           1    1                    
            1    1                    
     5    H 1    1           +        
   1111111111    1          11        
   1        1    1    5     11        
   1        1    1  11111111111       
   1        1    1                    
   1        1    1                    
   1        1    1                    
   1        1    1                    
<  1        1    1i                  >