x  33333333333333333333333333333333333  z
x       344444444444444444444444D       z
x       344444444444444444444444        z
x       344444444444444444444444 h      z
x     33334444444444444444444443333     z
x     34444444444444444444444444443 qr  z
x     34444444444444444444444444443     z
x      344444444444444444444444443      z
x      344444444444444444444444443   qr z
x33333333444444444444444444444443       z
x       3444444444444444444444443       z
x        34444444444444444444443      qrz
x    Kmh 3333333333333333333333         z
x    rrrw2111110111111111122222         z
x e      210001 100000001D211D        qrz
x        210001 100000001 101           z
x  m     211111 11K11m111 11h      m    z
x  e  e   22222222222222222222   2222   z
x         21111111111111111110  l       z 
x       e 21111111111111111m10 l        z
x         211111m11111m11K1110l         z
x   e     211222222222222222222         z
x         210111111111111111112         z
x     e   21111111111111m111112         z
x       e 222222222222222222112         z
x e       211111111111111111112         z
x    e    211111111111111111112         z
x         D01222221111111111222         z
x          01111112111111111112         z
x      h   01111112111111111112         z
x     222222221112222222222222222       z
xm      21111111l1111111111111112       z
x2vvvvv22100000l00000000000000012       z
x22222222112222100000000000000012       z
x       2100111100000000000000012       z
x       21hm000000000000000000012       z
x       2222100000000000000000012       z
x       2111000000000000000000012q      z
x       210000000000000000000000        z
x       2100m0000000000000000000        z
x       211122211122222111222110  K     z
x       211111111111111111111111 2222   z
x       2ddddddddddddddddddddddd2       z
x       2222222222222222222222222       z
x       2                       2     qrz
x      w2q                     7        z
x                  K s             rr   z
x                2222222                z
x         m 22222       22222           z
x m      222                 2222m      z
x qrw  22                       22     mz
x                                     aaz
x     a                              9ggz
x    9gy                             9ggz
xvvvvvgu                              igz
xtttttgy                              9gz
xtttttgy         lN                   cgz
xggggggnnnnnnnnnnnnnnnnnnnnnnnnnnnnnnnngz