x  33333333333333333333333333333333333  z
x       3P44444I44444444I4444444D       z
x       333334434444444333444444        z
x       3P4444444444444444444444 h      z
x     333334443G4I44344444444443333     z
x     3P444444433333444444443344443 qr  z
x     3344444444I444443344444444443     z
x      34444444433444444444444444I3      z
x      33P444444444444444444434G43   qr z
x33333333344444444344344344344333       z
x       34B4444444444444444444443       z
x        3  44443444G444G4444G43      qrz
x    Kmh 3333333333333333333333         z
x    rrrw2111111111111111122222         z
x e      2100000000000001D211D        qrz
x        2100000000000001 101           z
x  m     2E11111111Q1m111 11h      mh   z
x  e  e   22222222222222222222   2222   z
x         21111111111111111110  l       z 
x       e 21111111111111111m10 l        z
x         211121m11G11m11K1110l         z
x   e     211222222222222222222         z
x         210111111111111111112         z
x     e   211G1111G11111m112112         z
x       e 222222222222222222112         z
x e       211111111111111111112         z
x    e    211111111111111111112         z
x         D01222221111111111222         z
x          01111112111111111112         z
x      h   0111111211G11m11G112         z
x     222222221112222222222222222       z
xm      21111111l1111111111111112       z
x2vvvvv22100000l00000000000000012       z
x22222222112222100000000000000012       z
x       2100111100000000000000012       z
x       21h0000000000000000000012       z
x       2222100000000000000000012       z
x       2111000000000000000000012q      z
x       210000000000000000000000        z
x       2102mG20002G002002G02000        z
x       211222211122222112222110  K     z
x       211111111111111111111111 2222   z
x       2ddddddddddddddddddddddd2       z
x       2222222222222222222222222       z
x       2                       2     qrz
x      w2q                     7        z
x                    s             rr   z
x                2222222                z
x         m 22222       22222           z
x m      222                 2222m      z
x qrw  22                       22     mz
x                                     aaz
x     a                              9ggz
x    9gy                             9ggz
xvvvvvgu                              igz
xtttttgy         K                    9gz
xtttttgy         lN                   cgz
xggggggnnnnnnnnnnnnnnnnnnnnnnnnnnnnnnnngz