x  33333333333333333333333333333333333  z
x       3P44444I44444444I4444444D       z
x       333334434444444333444444        z
x       3P4444444444444444444444 h      z
x     333334443G I  344444444443333     z
x     3P444444433333444444443344443 qr  z
x     3344444444I444443344444444443     z
x      34444444433444444444444444I3     z
x      33P44444444444444444443 G 3   qr z
x333333333  444444344344344344333       z
x       34B  44444444444444444443       z
x        3   4443   G   G    G 3      qrz
x    Kmh 3333333333333333333333         z
x    rrrw2111111111111111122222         z
x e      2100000000000001D211D        qrz
x        2100000000000001 101           z
x  m     211K111111Q1m111 11h      mh   z
x  e  e   22222222222222222222   2222   z
x         21111111111111111110  l       z 
x       e 21111111111111111m10 l        z
x         21112 m  G  m  K    l         z
x   e     211222222222222222222         z
x         2                   2         z
x     e   2  G   m      m     2         z
x       e 222222222222222222112         z
x e       211111111111111111112         z
x    e    211111111111111111112         z
x         D01222221111111111222         z
x          01111112111111111112         z
x      h   0      2  G  m  G  2         z
x     222222221112222222222222222       z
xm      21111111l1111111111111112       z
x2vvvvv22100000l00000000000000012       z
x22222222112222100000000000000012       z
x       2100111100000000000000012       z
x       21h0000000000000000000012       z
x       2221100000000000000000012       z
x       2111000000000000000000012q      z
x       210000000000000000000000        z
x       2102mG20002G  2002G 2000        z
x       211222211122222112222110  K s   z
x       211111111111111111111111 2222   z
x       2dddddddddddddddddddddd22       z
x       2222222222222222222222222       z
x       2                       2     qrz
x      w2q                     7        z
x                                  rr   z
x                2222222                z
x         m 22222       22222           z
x m      222                 2222m      z
x qrw  22                       22     mz
x                                     aaz
x     a                              9ggz
x    9gy                             9ggz
xvvvvvgu                              igz
xtttttgy         K                    9gz
xtttttgy         lN                   cgz
xggggggnnnnnnnnnnnnnnnnnnnnnnnnnnnnnnnngz