

411111111111111111111111
477                    4
4                 5    4
4  5                   4
4      33            334
4              333666  4
4             33       4
4                      4
4   3336633            4
4                  5   4
4                      4
222222222222666222222662