B     1                              11                                 
      1              +               11
      11111  111111111111111111111  111
      1            1           111   11
      1            1                 11
      1            1                 11
      1-   e    =  1   -   e  =1     11
      11111111111  11  1111111111    11
1        1         1   1       1     11
y                  1           1     11
1                 11           1    111
1        1         1   1       1    111
1        1         1   11    5 1     11
1 5      11111111  11   11111111     11
11111    1         1     1     1     11
1        1         1           1     11
1  H     1        11  1        1     11
1  1     1         1           1     11
1111111  1  5      1     1   5 1     11
<     1  1111111111x*****1111111     1>