           5                        2
           5m      hm          m    2
           5f     444ll44      4    2
           5      l44   m    4l4l   2
           5                        2
           5 f   m    h4l44         2
           5    444  44444          2
           5        444l    m     m 2
           5  f             44h   f 2
           5           m  4l444     2
           5h         44            2
           56   m   444          f  2
           56rrr66                  2
           56666666 J       m       2
           5        66666       f   2
           5                        2
           5                 k      2
           5              n   0     2
           5 s         m 0     0   m2
           522222221888111wwwww188112
    