111111111111111111111111
4                      4
4                      4
4    33333             4
4                      4
4                      4
4                      4
4               33333  4
4                      4
4                      4
4       33333          4
4                      4
4                      4
222222222222222222222222