                        2
m      hm          m    2
f     444ll44      4    2
      l44   m    4l4l   2
                        2
 f   m    h4l44         2
    444  44444          2
        444l    m     m 2
  f             44h   f 2
           m  4l444     2
h         44            2
6   m   444          f  2
666666                  2
6666666         m       2
                    f   2
                        2
                 k      2
              n   0     2
 s         m 0     0   m2
22222221888111wwwww188112
    